Norma Fisher : ysullivan@yahoo.com 
Heather Snow : juancampos@lloyd.org 
Emily Blair : wcastro@yahoo.com 
Martin Harris : qgrimes@gmail.com 
Kimberly Smith : salazarmaria@yahoo.com 
Frederick Harrell : johnponce@west.net 
Mrs. Elizabeth Carter MD : tamaramorrison@hotmail.com 
Brandon Yates : kellylopez@gmail.com 
William Green : sheltondavid@mclean.net 
Sara Warren : pattylawrence@riley-hayes.com 
Louis Tucker : johndennis@gmail.com 
Jacqueline Jackson : garciadustin@hotmail.com 
Robert Walters : martinezjacob@wilson.com 
Alex Woodward : mendozajessica@giles.net 
Brian Green : lucasmichael@brown.com 
Melissa Myers : rebecca79@gmail.com 
Christina Saunders : matthewking@morse.biz 
Shelly Lowery : qmonroe@gmail.com 
Alexandria Harmon : stephensdennis@yahoo.com 
Dwayne Howard : paul61@wheeler.com 
Daniel West : moralesjacqueline@yahoo.com 
Michelle Martin : jacqueline78@odonnell-munoz.com 
Kathleen Collins : lambnancy@yahoo.com 
Zachary Schultz : valeriemorales@butler.com 
Miss Lisa Lee : joshua21@nash-sanders.com 
Thomas Marsh : dennis85@wiggins.com 
Daniel Green : sheena09@hotmail.com 
Mathew Ellis MD : nicholascarter@hernandez.com 
Michelle Morgan : nelsonedward@roberts.com 
Nicholas Peck : melodychandler@yahoo.com 
Gary Perry : zwells@martinez-wilson.info 
Eric Navarro : courtneybennett@miller.com 
Adam Long : ymora@hotmail.com 
Claudia Miller : brenda26@howard.com 
Jocelyn Rhodes : nsanders@williams.com 
Jimmy Ward : hintontonya@elliott.biz 
Kathleen Stark : obolton@hotmail.com 
Kimberly Velazquez : janice55@warren.org 
Sarah Aguilar : marshzachary@gmail.com 
Carlos Turner : michelle27@yahoo.com 
Stephanie Shaw : burgessrebecca@roberts.biz 
Karen Gibbs : melissayates@hotmail.com 
Natalie Turner : cameron44@yahoo.com 
James Martin : justingreer@mcmahon.biz 
Steve Guzman : lisagomez@carr.info 
John Hernandez : crystalgarcia@banks.info 
Antonio Haynes : montesjennifer@yahoo.com 
Bethany Buck : stonekristen@gmail.com 
James Watson : okelly@huber.info 
Alexander Meyer : claytonweiss@chan.com 
Brianna Snow : wallsrobert@gmail.com 
Christopher Blevins : bparks@yahoo.com 
Tonya Sharp : chad50@bailey-smith.com 
Andrea Barry : harrisemily@adkins.com 
Tasha Hall : shawnwoods@haley.com 
Tyler Phillips : brittanymiller@hotmail.com 
Brooke Hurst : lesliesanchez@carter.com 
Lindsay Long : robertpierce@house.com 
Jeremy Wood : aortiz@valenzuela.info 
Cody Rodriguez : lauragriffin@lopez-fisher.com 
Jesse Giles : steven17@phillips.info 
Aimee Evans : rogerpotter@gmail.com 
Olivia Hall : crystal01@yahoo.com 
Amanda Scott : qgarcia@yahoo.com 
Paul Stout : jonesjose@morgan.com 
Scott Campbell : amandajenkins@stephens.com 
Jacob Fuller : terrypatrick@mcdonald.info 
Claudia Burns : dpearson@yahoo.com 
Patrick Williams : kellypeter@mathis.com 
Natalie Caldwell : blake90@marks-lyons.com 
Kenneth Lee : ymoran@gmail.com 
Matthew Mcdaniel : jfitzpatrick@stewart.com 
Jasmine Roman : lauragonzales@gmail.com 
Amber Price : pittsmichael@little.org 
Sean Walton : oellis@hotmail.com 
Tina Blevins : thenry@yahoo.com 
Derek Williams : adam02@buchanan.com 
Jennifer Morse : matthewgarcia@gmail.com 
Erica Bryant : anthony03@yahoo.com 
Sergio Reed : emily44@heath.com 
Timothy Jones : dhardy@yahoo.com 
Julia Wilson : coreycannon@henson-lewis.org 
Jeffery Fischer : haleyjohn@gmail.com 
Seth Michael : srodriguez@hotmail.com 
Christina Phillips : qherrera@yahoo.com 
Bryan Logan : jessicawright@hobbs-osborn.com 
Kaylee Trevino : hbrewer@cunningham.net 
Connie Decker : holmesemily@brooks.com 
Breanna Smith : brenda02@yahoo.com 
Christopher Esparza : kimberlyhampton@saunders.com 
Olivia Gomez : glester@flowers.info 
Tyler Peters : vlamb@payne-padilla.com 
Larry Warner : patrick03@gmail.com 
Paul Wright : jordanpowers@yahoo.com 
Kenneth Brown : andrew00@williams.com 
Antonio Stanton : patriciarobinson@yahoo.com 
Eric Banks : qsmith@hotmail.com 
Nancy Parks : cunninghamdavid@yahoo.com 
Jonathan Howell : riveramary@wright.com 
Sara Hoffman : mpennington@oliver. com
